####################
####..@...#h######B#
####.###g.#s######@#
####.##...#.##..@..#
####@##.g#g.##.t.###
####.##...#.##@..###
####..##g.#.##.#####
#.@.g.###...##.#####
#.g...##g####g.#####
#.######.#####.#####
#@######.##g##.#####
#.##g###@#####.#g###
#...@........@......
########g###b#######
####################
1 11

12 18

0 180
0 150
0 120
0 90
0 60
0 30
0 210
0 240