####################
##@#####h......#####
##.###########.#####
##...@...........g##
##.#########.####@##
##...........###..##
##....#..###.#....##
##.s....t.......v.##
##....#..###.....g##
##..g....#B#..#.#.##
##............#.#.##
##@.######..t##.#.##
##..@.....#####.#.##
##########b.....####
###############.####

1 2
12 17

14 15

0  123
2  1 8 10
1 -1 1 9
