####################
##h############g####
##.#########t@..####
##s############.####
##.############@####
##.....@...B.##.####
##.############.####
##.#####....@...g###
##.#####@g##########
##.##g##.###t.######
##....@..###.b######
##.####g#######g#g#g
##.#################
##........@.........
####################

9 13
2 13

13 18

0 90
0 80
0 70
0 60
0 50
0 40
0 30
0 20
